11111112222211111111122222222222
14434412222113433334122222222222
13383312221143333333122222222222
13333312221333737333122222222222
14333412221373333373121111111112
14333412221333333333111433333312
11131112221333333333111333333612
11373122221333333563311331111312
21333111111633633333331331221312
21433333333333533333331561221312
21111111111333333333333331221312
22222222221333333333733331221312
22222222221143336633333331211511
11111111122111111111111111214541
13543334122222222222222222211311
13335335121111122222221111214341
13333333121363121111111341211311
13353333121313121336433331221312
15333335111313111333363331211312
13333333333613333333333631115312
14535333111111146633333333333112
15333511122212111133336336111122
11333112222222222133311111122222
11535122222222222143112222222222
21101122222222222111122222222222
22131222222222222222222222222222
